[console_scripts]
lttng-cputop = lttnganalyses.cli.cputop:run
lttng-cputop-mi = lttnganalyses.cli.cputop:run_mi
lttng-iolatencyfreq = lttnganalyses.cli.io:runfreq
lttng-iolatencyfreq-mi = lttnganalyses.cli.io:runfreq_mi
lttng-iolatencystats = lttnganalyses.cli.io:runstats
lttng-iolatencystats-mi = lttnganalyses.cli.io:runstats_mi
lttng-iolatencytop = lttnganalyses.cli.io:runlatencytop
lttng-iolatencytop-mi = lttnganalyses.cli.io:runlatencytop_mi
lttng-iolog = lttnganalyses.cli.io:runlog
lttng-iolog-mi = lttnganalyses.cli.io:runlog_mi
lttng-iousagetop = lttnganalyses.cli.io:runusage
lttng-iousagetop-mi = lttnganalyses.cli.io:runusage_mi
lttng-irqfreq = lttnganalyses.cli.irq:runfreq
lttng-irqfreq-mi = lttnganalyses.cli.irq:runfreq_mi
lttng-irqlog = lttnganalyses.cli.irq:runlog
lttng-irqlog-mi = lttnganalyses.cli.irq:runlog_mi
lttng-irqstats = lttnganalyses.cli.irq:runstats
lttng-irqstats-mi = lttnganalyses.cli.irq:runstats_mi
lttng-memtop = lttnganalyses.cli.memtop:run
lttng-memtop-mi = lttnganalyses.cli.memtop:run_mi
lttng-periodfreq = lttnganalyses.cli.periods:runfreq
lttng-periodfreq-mi = lttnganalyses.cli.periods:runfreq_mi
lttng-periodlog = lttnganalyses.cli.periods:runlog
lttng-periodlog-mi = lttnganalyses.cli.periods:runlog_mi
lttng-periodstats = lttnganalyses.cli.periods:runstats
lttng-periodstats-mi = lttnganalyses.cli.periods:runstats_mi
lttng-periodtop = lttnganalyses.cli.periods:runtop
lttng-periodtop-mi = lttnganalyses.cli.periods:runtop_mi
lttng-schedfreq = lttnganalyses.cli.sched:runfreq
lttng-schedfreq-mi = lttnganalyses.cli.sched:runfreq_mi
lttng-schedlog = lttnganalyses.cli.sched:runlog
lttng-schedlog-mi = lttnganalyses.cli.sched:runlog_mi
lttng-schedstats = lttnganalyses.cli.sched:runstats
lttng-schedstats-mi = lttnganalyses.cli.sched:runstats_mi
lttng-schedtop = lttnganalyses.cli.sched:runtop
lttng-schedtop-mi = lttnganalyses.cli.sched:runtop_mi
lttng-syscallstats = lttnganalyses.cli.syscallstats:run
lttng-syscallstats-mi = lttnganalyses.cli.syscallstats:run_mi

